É Í Í Í Í Í Í Í Í Í Í Í Í Í Í Í Í Í Í Í » 
º                                       º 
º                                       º 
º         T     T                       º 
º     T                       T         º 
º       T                               º 
º                                 T     º 
º         T       P                     º 
º   T                                   º 
º                           T   T       º 
º                                       º 
º                                     T º 
º   T     T   T                   T     º 
º                                       º 
º                                       º 
º                                       º 
º   T                         T         º 
º T                       T   M       T º 
º                                       º 
º                                       º 
È Í Í Í Í Í Í Í Í Í Í Í Í Í Í Í Í Í Í Í ¼ 

